#######################
#  *    *     *    *  #
# ### ## ##### ## ### #
#*###*##       ##*###*#
# ### ## ## ## ## ### #
#     ## ## ## ##     #
# ###### ## ## ###### #
#*##   *       *   ##*#
# ## ######*###### ## #
#     *         *     #
# ####### ### ####### #
#   *     ###     *   #
# #### ## ### ## #### #
# #### ##     ## #### #
#*#### ## ### ## ####*#
#     *## ### ##*     #
#*####### ### #######*#
#           0         #
#######################