############################
#O           ##           O#
# #### ##### ## ##### #### #
# #### ##### ## ##### #### #
# #### ##### ## ##### #### #
#                          #
# #### ## ######## ## #### #
# #### ## ######## ## #### #
#      ##    ##    ##      #
###### ##### ## ##### ######
###### ##### ## ##### ######
###### ##          ## ######
###### ## ######## ## ######
###### ## ######## ## ######
#P        ########        P#
###### ## ######## ## ######
###### ## ######## ## ######
###### ##          ## ######
###### ## ######## ## ######
###### ## ######## ## ######
#            ##            #
# #### ##### ## ##### #### #
# #### ##### ## ##### #### #
#   ##                ##   #
### ## ## ######## ## ## ###
### ## ## ######## ## ## ###
#      ##    ##    ##      #
# ########## ## ########## #
# ########## ## ########## #
#O                        O#
############################